9
6
XXXXXXXXX
X       X
X       X
X  X    X
XG X B PX
XXXXXXXXX
